7 9
XXXXXXXXX
X.......X
X...X...X
X...X...X
X...X...X
X.......X
XXXXXXXXX