XXXXXXXXXXXX
X$.........X
X..........X
X..........X
X..........X
X..........X
X..........X
X..........X
X..........X
X..........X
X..........X
XXXXXXXXXXXX

XXXXXXXXXXXX
X&.........X
X$.........X
X..........X
X..........X
X..........X
X..........X
X..........X
X..........X
X..........X
X..........X
XXXXXXXXXXXX

XXXXXXXXXXXX
X&.........X
X&$........X
X..........X
X..........X
X..........X
X..........X
X..........X
X..........X
X..........X
X..........X
XXXXXXXXXXXX

XXXXXXXXXXXX
X&.........X
X&&........X
X.$........X
X..........X
X..........X
X..........X
X..........X
X..........X
X..........X
X..........X
XXXXXXXXXXXX

XXXXXXXXXXXX
X&.........X
X&&........X
X.&$.......X
X..........X
X..........X
X..........X
X..........X
X..........X
X..........X
X..........X
XXXXXXXXXXXX

XXXXXXXXXXXX
X&.........X
X&&........X
X.&&.......X
X..$.......X
X..........X
X..........X
X..........X
X..........X
X..........X
X..........X
XXXXXXXXXXXX

XXXXXXXXXXXX
X&.........X
X&&........X
X.&&.......X
X..&$......X
X..........X
X..........X
X..........X
X..........X
X..........X
X..........X
XXXXXXXXXXXX

XXXXXXXXXXXX
X&.........X
X&&........X
X.&&.......X
X..&&......X
X...$......X
X..........X
X..........X
X..........X
X..........X
X..........X
XXXXXXXXXXXX

XXXXXXXXXXXX
X&.........X
X&&........X
X.&&.......X
X..&&......X
X...&$.....X
X..........X
X..........X
X..........X
X..........X
X..........X
XXXXXXXXXXXX

XXXXXXXXXXXX
X&.........X
X&&........X
X.&&.......X
X..&&......X
X...&&.....X
X....$.....X
X..........X
X..........X
X..........X
X..........X
XXXXXXXXXXXX

XXXXXXXXXXXX
X&.........X
X&&........X
X.&&.......X
X..&&......X
X...&&.....X
X....&$....X
X..........X
X..........X
X..........X
X..........X
XXXXXXXXXXXX

XXXXXXXXXXXX
X&.........X
X&&........X
X.&&.......X
X..&&......X
X...&&.....X
X....&&....X
X.....$....X
X..........X
X..........X
X..........X
XXXXXXXXXXXX

XXXXXXXXXXXX
X&.........X
X&&........X
X.&&.......X
X..&&......X
X...&&.....X
X....&&....X
X.....&$...X
X..........X
X..........X
X..........X
XXXXXXXXXXXX

XXXXXXXXXXXX
X&.........X
X&&........X
X.&&.......X
X..&&......X
X...&&.....X
X....&&....X
X.....&&...X
X......$...X
X..........X
X..........X
XXXXXXXXXXXX

XXXXXXXXXXXX
X&.........X
X&&........X
X.&&.......X
X..&&......X
X...&&.....X
X....&&....X
X.....&&...X
X......&$..X
X..........X
X..........X
XXXXXXXXXXXX

XXXXXXXXXXXX
X&.........X
X&&........X
X.&&.......X
X..&&......X
X...&&.....X
X....&&....X
X.....&&...X
X......&&..X
X.......$..X
X..........X
XXXXXXXXXXXX

XXXXXXXXXXXX
X&.........X
X&&........X
X.&&.......X
X..&&......X
X...&&.....X
X....&&....X
X.....&&...X
X......&&..X
X.......&$.X
X..........X
XXXXXXXXXXXX

XXXXXXXXXXXX
X&.........X
X&&........X
X.&&.......X
X..&&......X
X...&&.....X
X....&&....X
X.....&&...X
X......&&..X
X.......&&.X
X........$.X
XXXXXXXXXXXX

XXXXXXXXXXXX
X&.........X
X&&........X
X.&&.......X
X..&&......X
X...&&.....X
X....&&....X
X.....&&...X
X......&&..X
X.......&&.X
X........&$X
XXXXXXXXXXXX

